NO ./textures/north.xpm42
EA ./textures/east.xpm42
WE ./textures/west.xpm42
SO ./textures/south.xpm42

F 150, 100, 192
C 171, 200, 212

111111111111111111111111111111111
100000000000000000000000000001111
100000000000000000000000000W01111
100000000000000000000000000001111
111111111111111111111111111111111
111111111111111111111111111111111
111111111111111111111111111111111
