NO ./textures/winter.xpm42
EA ./textures/autumn.xpm42
WE ./textures/spring.xpm42
SO ./textures/summer.xpm42

F 150, 100 22111111
C 171, 200, -1

1111111111
11001N0111
1111101111
1111111111