NO ./textures/winter.xpm42
EA ./textures/autumn.xpm42
WE ./textures/spring.xpm42
SO ./textures/summer.xpm42

F 150, 100, 192
C 171, 200, 212

1000000001100100000000011
1011000001110000011111111
11111111111111111111   11
1111111111111111111111111
1001000000000000000000001
